"filename", "language", "Python", "JSON", "comment", "blank", "total"
"d:\PyGames\OpenFarm\assetloader.py", "Python", 75, 0, 0, 3, 78
"d:\PyGames\OpenFarm\audio.py", "Python", 62, 0, 0, 14, 76
"d:\PyGames\OpenFarm\data\audio.json", "JSON", 0, 1, 0, 0, 1
"d:\PyGames\OpenFarm\easy_visualizer.py", "Python", 33, 0, 2, 11, 46
"d:\PyGames\OpenFarm\main.py", "Python", 20, 0, 0, 3, 23
"d:\PyGames\OpenFarm\settings.py", "Python", 55, 0, 5, 9, 69
"d:\PyGames\OpenFarm\spritesheet.py", "Python", 20, 0, 0, 6, 26
"d:\PyGames\OpenFarm\support.py", "Python", 142, 0, 5, 28, 175
"d:\PyGames\OpenFarm\world\generic.py", "Python", 77, 0, 0, 15, 92
"d:\PyGames\OpenFarm\world\house.py", "Python", 199, 0, 5, 20, 224
"d:\PyGames\OpenFarm\world\inventory.py", "Python", 43, 0, 0, 10, 53
"d:\PyGames\OpenFarm\world\player.py", "Python", 150, 0, 0, 23, 173
"d:\PyGames\OpenFarm\world\soil.py", "Python", 83, 0, 6, 20, 109
"d:\PyGames\OpenFarm\world\sprites.py", "Python", 115, 0, 0, 18, 133
"d:\PyGames\OpenFarm\world\transition.py", "Python", 51, 0, 4, 6, 61
"d:\PyGames\OpenFarm\world\ui.py", "Python", 248, 0, 5, 36, 289
"d:\PyGames\OpenFarm\world\world.py", "Python", 65, 0, 0, 11, 76
"d:\PyGames\OpenFarm\world\zone.py", "Python", 218, 0, 0, 30, 248
"Total", "-", 1656, 1, 32, 263, 1952